~~~~~~~~~~~~~~~~~~~~~~~~~
#~~~~~~~~~~~~~~~~~~~~~~~~
~~~~~~~~~~~~~~~~#~~~~~~#~
~~~~~~~~~~~~~~~~~~~~#~~~~
~~~~~~~~~~~~~~#~~~~~##~~~
~~~~~~~~#~~~~~~~~~~~~~#~~
~~~~~~~~~~~~~~~~~~~~~~~~~
~~~~~~~~~~~~~~~~~~~~~~#~~
~~~~~~~~~~~~~~~~~~~~~~~~~
~~~~~~~~~~~~~~~~~~~#~~#~~
~~~~~~~~~#~~~~~~~~~~~~~~~
~~~~#~#~~~~~~~~~~~##~~~~~
~~~~~~~~~~~~~~~#~~~~~~~#~
~#~~~~#~~~~~#~~~#~~~~~~~~
~~~~~~~~~~#~~~~~~~~~~~~~#
~~~~~#~~~~~~#~~~~~~~~~~#~
~~~~~~~~~~~~~~~#~~~~~#~~~
~~~~~~~~~#~#~~~~~~~~~~~~~
~~~~~~~#~~~~~~~~~~~~~~~~#
~~~~~~~~~~~~#~~~~~~~~~~~~
~~~~~~~~~~~~~~~~~~~#~~~~~
~~~~~~#~~~~~~~~~~~~~~~~~~
~~~~#~#~~~~~~~~~~~~~~~~~~
~~~~~~~~~~~~~~~~~~~~~~~~~
~~~~~~~~~~~~~~~~~#~~~~~~~
